NO         ./path_to_the_north_texture      yty      
SO  ./path
WE ./path_to_the_west_texture
EA ./pewafdk


C  25     , 25 , 30
F 220  ,        100 ,  1

        
         
1111111
110N1
1001
1001                             
11111111
1





        
  