NO         ./path_to_the_north_texture      yty      
SO  ./path
WE ./path_to_the_west_texture
EA ./path_to_the_east_texture


C  25     , 25 , 30 
F 220  ,        100  ,  1


    111111  111111
    100011  111011                
    111001 1111111               
    1100N1                      
    11111              
11111111


nettoyer le fichier entre les lignes
gerer les whitespaces de new map apres la fin des 1 et 0
gerer les espaces dans la map (floodfill);