NO         ./path_to_the_north_texture      yty      
SO  ./path
WE ./path_to_the_west_texture
EA ./path_to_the_east_texture

C 225,30, 52
F 220  ,        100  ,  85


111 1 1111111 111111     11111111
1100000000110000000000001
1011000001110000000000001
100100000000000000000001
111111111011000001110000000000001
100000000011000001110111111111111
11110111111111011100000010001
11110111111111011101010010001
110000001101010111000010001
1000000000000E00110000001000
10000000000000001101010010001
110000011101010111110111100111
11110111 1110101 101111010001
11111111 1111111 111111111111
